Africâner : af
Albanês : sq
Amárico : am
Árabe : ar
Armênio : hy
Azerbaijano : az
Basco : eu
Bengali : bn
Bielorrusso : be
Birmanês : my
Bósnio : bs
Búlgaro : bg
Canará : kn
Catalão : ca
Cazaque : kk
Chichewa : ny
Chinês : zh
Cmer : km
Cingalês : si
Coreano : ko
Croata : hr
Curdo : ku
Córsico : co
Dinamarquês : da
Eslovaco : sk
Esloveno : sl
Esperanto : eo
Estoniano : et
Filipino : tl
Finlandês : fi
Frísio : fy
Galego : gl
Galês : cy
Gaélico escocês : gd
Georgiano : ka
Grego : el
Guzerate : gu
Hauçá : ha
Haitiano : ht
Hebraico : he
Hebraico : iw
Hindi : hi
Holandês : nl
Húngaro : hu
Iídiche : yi
Igbo : ig
Indonésio : id
Iorubá : yo
Irlandês : ga
Islandês : is
Japonês : ja
Javanês : jv
Laosiano : lo
Letão : lv
Lituano : lt
Luxemburguês : lb
Macedônio : mk
Malaiala : ml
Malaio : ms
Malgaxe : mg
Maltês : mt
Maori : mi
Marata : mr
Mongol : mn
Nepalês : ne
Norueguês : no
Pashto : ps
Persa : fa
Polonês : pl
Punjabi : pa
Quirguiz : ky
Romeno : ro
Russo : ru
Samoano : sm
Sesoto : st
Sindi : sd
Somali : so
Suaíli : sw
Sueco : sv
Sundanês : su
Sérvio : sr
Tailandês : th
Tajique : tg
Tcheco : cs
Telugu : te
Turcomano : tk
Turco : tr
Tártaro : tt
Tâmil : ta
Ucraniano : uk
Urdu : ur
Usbeque : uz
Uyghur : ug
Vietnamita : vi
Xona : sn
Xosa : xh
Zulu : zu